40
50
41 29 29 29 29 29 29 29 29 29 29 29 29 29 29 29 29 29 29 29 29 29 29 29 29 29 29 29 29 29 29 29 29 29 29 29 29 29 29 42
27 5 5 5 5 5 20 5 5 5 5 5 5 5 5 5 20 5 5 5 20 5 5 20 5 5 5 5 5 20 5 5 5 5 5 5 20 5 5 25 
27 5 5 5 5 5 20 5 5 5 5 5 5 5 5 5 20 5 5 5 20 5 5 20 5 5 5 5 5 20 5 5 5 5 5 5 20 5 5 25 
27 5 5 5 5 5 20 20 20 20 20 20 20 20 5 5 20 5 5 5 20 5 5 20 5 5 20 5 5 20 5 5 5 20 20 20 20 5 5 25 
27 5 5 5 5 5 20 5 5 5 5 5 5 20 5 5 20 5 5 5 5 5 5 20 5 5 20 5 5 5 5 5 5 20 5 5 5 5 5 25 
27 5 5 5 5 5 20 5 5 5 5 5 5 20 5 5 20 5 5 5 5 5 5 20 5 5 20 5 5 5 5 5 5 20 5 5 20 5 5 25 
27 5 5 5 5 5 20 5 5 5 5 5 5 20 5 5 20 5 5 5 5 5 5 20 5 5 20 20 20 20 20 20 20 20 5 5 20 5 5 25 
27 5 5 20 20 20 20 5 5 20 5 5 5 20 5 5 20 5 5 5 20 20 20 20 5 5 5 5 5 20 5 5 5 5 5 5 20 5 5 25 
27 5 5 5 5 5 20 5 5 20 5 5 5 20 5 5 20 5 5 5 20 5 5 5 5 5 5 5 5 20 5 5 5 5 5 5 20 5 5 25 
27 20 20 20 5 5 20 5 5 20 5 5 5 20 5 5 20 5 5 5 20 5 5 5 5 5 5 5 5 20 20 20 20 20 20 20 20 5 5 25 
27 20 20 20 5 5 20 5 5 20 5 5 5 20 5 5 20 5 5 5 20 5 5 20 20 20 20 20 20 20 20 20 20 20 20 20 20 5 5 25 
27 20 20 20 5 5 20 5 5 20 5 5 5 20 5 5 20 5 5 5 20 5 5 20 5 5 5 5 5 20 5 5 5 5 5 5 20 5 5 25 
27 20 20 20 5 5 20 5 5 20 5 5 5 20 5 5 20 5 5 5 20 5 5 20 5 5 5 5 5 20 5 5 5 5 5 5 20 5 5 25 
27 20 20 20 5 5 20 5 5 20 5 5 5 20 5 5 20 5 5 5 20 5 5 20 5 5 20 20 20 20 20 20 20 20 5 5 20 5 5 25 
27 5 5 5 5 5 5 5 5 20 5 5 5 20 5 5 5 5 5 5 20 5 5 5 5 5 20 5 5 5 5 5 5 5 5 5 20 5 5 25 
27 5 5 5 5 5 5 5 5 20 5 5 5 20 5 5 5 5 5 5 20 5 5 5 5 5 20 5 5 5 5 5 5 5 5 5 20 5 5 25 
27 20 20 20 20 20 20 20 20 20 5 5 5 20 20 20 20 20 20 20 20 20 20 20 5 5 20 5 5 5 20 20 20 20 5 5 20 5 5 25 
27 5 5 5 5 5 5 5 5 5 5 5 5 20 5 5 5 5 5 5 5 5 5 20 5 5 20 5 5 5 20 5 5 5 5 5 20 5 5 25 
27 5 5 5 5 5 5 5 5 5 5 5 5 20 5 5 5 5 5 5 5 5 5 20 5 5 20 5 5 5 20 5 5 5 5 5 20 5 5 25 
27 20 20 20 20 20 20 5 5 20 20 20 20 20 20 20 20 20 20 20 20 5 5 20 5 5 20 5 5 5 20 5 5 5 5 5 20 5 5 25 
27 20 20 20 20 20 20 5 5 20 20 20 20 20 20 20 20 20 20 20 20 5 5 20 5 5 20 5 5 5 20 5 5 20 5 5 20 5 5 25 
27 5 5 5 5 5 20 5 5 20 5 5 5 5 5 5 5 5 5 5 20 5 5 20 5 5 20 5 5 5 20 5 5 20 5 5 5 5 5 25 
27 5 5 5 5 5 20 5 5 20 5 5 5 5 5 5 5 5 5 5 20 5 5 20 5 5 20 5 5 5 20 5 5 20 5 5 5 5 5 25 
27 5 5 20 5 5 20 5 5 20 20 20 20 20 20 20 20 5 5 5 20 5 5 20 5 5 20 5 5 5 20 5 5 20 20 20 20 20 20 25 
27 5 5 20 5 5 20 5 5 20 5 5 5 20 5 5 5 5 5 5 20 5 5 20 5 5 20 5 5 5 20 5 5 20 5 5 5 5 5 25 
27 5 5 20 5 5 20 5 5 20 5 5 5 20 5 5 5 5 5 5 20 5 5 20 5 5 20 5 5 5 20 5 5 20 5 5 5 5 5 25 
27 5 5 20 5 5 5 5 5 20 5 5 5 20 5 5 5 20 20 20 20 5 5 20 5 5 20 5 5 5 20 5 5 20 20 20 20 5 5 25 
27 5 5 20 5 5 5 5 5 20 5 5 5 20 5 5 5 5 5 5 20 5 5 20 5 5 20 5 5 5 20 5 5 5 5 5 20 5 5 25 
27 5 5 20 5 5 5 5 5 20 5 5 5 20 5 5 5 5 5 5 20 5 5 5 5 5 20 5 5 5 20 5 5 5 5 5 20 5 5 25 
27 5 5 20 5 5 5 5 5 20 5 5 5 20 5 5 5 5 5 5 20 5 5 5 5 5 20 5 5 5 20 20 20 20 20 20 20 5 5 25 
27 5 5 20 20 20 20 20 20 20 5 5 5 20 20 20 20 5 5 5 20 5 5 5 5 5 20 5 5 5 20 20 20 20 20 20 20 5 5 25 
27 5 5 5 5 5 5 5 5 5 5 5 5 5 5 5 20 5 5 5 20 20 20 20 20 20 20 5 5 5 20 5 5 5 5 5 20 5 5 25 
27 5 5 5 5 5 5 5 5 5 5 5 5 5 5 5 20 5 5 5 20 5 5 20 5 5 20 5 5 5 20 5 5 5 5 5 20 5 5 25 
27 5 5 20 20 20 20 5 5 20 20 20 20 20 5 5 20 5 5 5 20 5 5 20 5 5 20 5 5 5 20 5 5 20 5 5 20 5 5 25 
27 5 5 5 5 5 20 5 5 20 5 5 5 5 5 5 20 5 5 5 20 5 5 20 5 5 5 5 5 5 5 5 5 20 5 5 20 5 5 25 
27 5 5 5 5 5 20 5 5 20 5 5 5 5 5 5 20 5 5 5 20 5 5 20 5 5 5 5 5 5 5 5 5 20 5 5 20 5 5 25 
27 20 20 20 5 5 20 5 5 20 5 5 5 20 20 20 20 5 5 5 20 5 5 20 20 20 20 20 20 20 20 20 20 20 5 5 20 5 5 25 
27 5 5 5 5 5 20 5 5 20 5 5 5 20 5 5 20 5 5 5 20 5 5 5 5 5 5 5 5 5 5 5 5 5 5 5 5 5 5 25 
27 5 5 5 5 5 20 5 5 20 5 5 5 20 5 5 20 5 5 5 20 5 5 5 5 5 5 5 5 5 5 5 5 5 5 5 5 5 5 25 
27 5 5 20 20 20 20 5 5 20 5 5 5 20 5 5 20 5 5 5 20 20 20 20 20 20 20 20 20 20 20 20 20 20 20 20 20 5 5 25 
27 5 5 20 20 20 20 5 5 20 5 5 5 20 5 5 20 5 5 5 20 20 20 20 20 20 20 20 20 20 20 20 20 20 20 20 20 5 5 25 
27 5 5 5 5 5 20 5 5 20 5 5 5 20 5 5 5 5 5 5 5 5 5 20 5 5 5 5 5 5 5 5 5 5 5 5 20 5 5 25 
27 5 5 5 5 5 20 5 5 20 5 5 5 20 5 5 5 5 5 5 5 5 5 20 5 5 5 5 5 5 5 5 5 5 5 5 20 5 5 25 
27 5 5 20 20 20 20 5 5 20 5 5 5 20 20 20 20 20 20 20 20 5 5 20 20 20 20 20 20 20 20 5 5 5 5 5 5 5 5 25 
27 5 5 20 5 5 20 5 5 20 5 5 5 20 5 5 5 5 5 5 20 5 5 5 5 5 5 5 5 5 5 5 5 5 5 5 5 5 5 25 
27 5 5 20 5 5 20 5 5 20 5 5 5 20 5 5 5 5 5 5 20 5 5 5 5 5 5 5 5 5 5 5 5 5 5 5 5 5 5 25 
27 5 5 20 5 5 20 5 5 20 5 5 5 20 20 20 20 5 5 5 20 20 20 20 20 20 20 20 20 20 5 5 5 5 50 51 52 53 55 25 
27 5 5 20 5 5 5 5 5 20 5 5 5 5 5 5 5 5 5 5 5 5 5 5 5 5 5 5 5 5 5 5 5 5 60 61 62 63 65 25 
27 5 5 20 5 5 5 5 5 20 5 5 5 5 5 5 5 5 5 5 5 5 5 5 5 5 5 5 5 5 5 5 5 5 70 71 72 73 75 25 
43 23 23 23 23 23 23 23 23 23 23 23 23 23 23 23 23 23 23 23 23 23 23 23 23 23 23 23 23 23 23 23 23 23 23 23 23 23 23 44